.#######...#.###.##..#.....#####....#.#...#..##..##.###.....####...#.#..#.###...#.#.##...#..##.###..##......##....##....#.#..#...##.###..#.#.#####..##.##....#.#####.#.######...#.####....#.#.####..#.####.#.#..##......#....#.##...#...#...#......#...#...#.#.....###..#.##..#...####.##....#.#.#...##...####.#####.####.###.##.###.##...#.#.#...###.######....#.#.#.#..#.#....#####.#.##...##...##...##...#.#.#####.#...#.#######..#...##..#..#...#..####....###..#..##.##..#.#.##...#####......#.#.###.####...#.#.###.#.##.#.

###....###.#.#####.#..#..#.##...##.#.##.#..##..####..##....#.##.###..##....#####.#..#.######.#.#.##.
.##....######....#..#....###.#..##.#...##..#..#####..#.###...####.####...#.######.#.#.##.####.#.####
#.......#..#.#.##.##.##.#.##..###...###.#.#..#####...#..####.###..#.#..#.###.#..#..#.###.##..#...##.
....#......####.#...#.##.#..##....####.#.....####.#..##..#...#.##...#.#.##..##......#....#..#.##....
####..#.#....#...#.######.#.####.#.####.#####..###...##.#.###.##...##.........#.##.#..###..#.##...##
.##..#.#..#...#####.......#.##.#....###.#..###..##.##.#....###.##.#.#..##..#.#.....#.#.###...###.#..
..#.##.#...#.#..#.##.##..#.##.#...###..##..#.#..#..##..#.#.###.##.##...##.###....#.###...#.###..#...
####....#######.#.#..#..###......##..###.#.#.#.#.#..###.##...###.##.##..##.#..#.#.##..#..#..###..#.#
..##..###.##......###.####.#....##.##.#..#..#...#.####......###.#.##.#..#.##.......#..#...#..###.###
##.##.##..#.##..#..#..##.###..###..#.##.###.#...####.#.#......###........##.#.#######.#.#...###.##.#
.##.#...#..###.###..###.##.##.#..##.#.#.#...#....######.#...#.....##...##.#.#....###.###....#.#.##..
##...#..#.#.#.#.#.###.....#....##.##.#.##.##...#.#.#.#.#...#....####..##..#.####........#...#.##....
.#.#####.#...###.###..##.##.##..#...###.##.#.#..#..#.#.###..#.###..#.#..####..#......####.#.#....###
##.#####.#...#..#..##..###.##.##..#.......#.####.#.#..####..###.....###.....#..#..#..#.##....####...
.##.##.#.#..##..####...#..#..#..#.#.#.#.####.####.#####.....#.#.##..#...#.###.#.....#..####.#.##.###
###.#.....#..#..##........#.#..##....##.###..#.#..#..#.#####..##.#.###..##.#######...#..#.....##.###
.##.##..##..##..##..####.##.#..##..####.##.##.#.##..#.##.###..#.##.#...#.###..#.#.###.#####..#.#.#..
...#.#...#..#...#....####.....##...###...#..######.##..##.##..###...#..###..###.##..####.###.###.#..
##.#..##....#.#.##..##......#..##.....##.##..#.##...##.##.#####.#....#.#..#...#.#....#.###...###....
.#.#......##.#...#...###....###...##.#.###.#...#..#######..#######.#....###.#..#.#.#.##....#.#..#.##
###.####...#....#...#####.#.###.#.#.#......##.##..#.#####..#.####.##.##.##..###.##...##..#.##...##..
####.##...##....#..###.#...#.#.#...#..##..##.##.##..#.#.####..#..#.#.#.####......#.###.##.....#...##
.##.##..#.#....######.##......#...#.#.####..#.####.##.##.###.#.#..######.######.#.#...#.######..#...
#....##.#.##.#.###..#####.###.##.#...#..#.#..###.#....#.###..#..#.#..#.###...#.....#..##............
#.#.###..##.###...#..###.#.##.#####.##.#...#...#........#....###.#######..##.#.....#..#.#.###..####.
..####.##..#.##.#.....#....##....#..######.#..#...#......#.##..##.#.#..######..###..##.#.#.###...###
##....#..##.#..#.#....#...###..#.###......##.##.#.#.#..#...###....#.###.##....###.###.#..###..#.###.
##...###.####.#...#.####.##.#...#.##....#.....#.##..##..#####.#.#.......#.#..#...#.##.###.....######
#.###...##..##.##.####....##.#..###########.#..##..#...#.##.###...#...#..##.#.....#.#..##.##...#.#..
....#..##...#.#####.#.####.#..##..###.###..#.#.##..#.#.#.#..#.....##..######.####.#####.#....##..#.#
##..##.#.#.##..#..#....#.#.#..##.###.......#.###..#.#..####...##...#####......####..##.#.#.##.####.#
#####.#.##.#....#.##....#...###.##..##...#...#.###..###..##.###.#.#.#.#...#.#..#.#.##.#.##.######.##
#.##..#.##.#.###.##..#####..#.....#.###..##.#.#.####.###.#....###...#.#..#..##..#.##....#.##.##.###.
.#...##..##.#..#..##.##..#.#.........##.#######...#.#......##########..##.##..#.#.###.....#....#####
##.......#.##.#..#.####..##.#.####.##..#.#....#..#..#.###.#.#.#.##..####..##.##.#..#..#.##..#.##..#.
#######...........#...####.####........##.###.###.#.###.###.##.#.##.#..#.####...###..#..###...##...#
.##......#.####.####..#.#......###.#.##.#####..###.##....#.##..##.#.##.#.#..#####..#.#...#..#.##..##
..#.####..###.#.##.#..##.###..###.#..#...#########...#.....#.##....###....#..#..#.##.#...###..###.##
###.#.##.#.#...#..##.###.#.#...#.##.#..#..#..#.#.#.#..##.#.###.#....#......###..##.#.#.####.##...#.#
.##...........#..#..#.#....##..#.#.###.#.#.###.##.#..##...#...##..###.#......#.##.##...#..##.#......
##..###..##.#..##..##..####...#......###.#.###...#.###..#.#.#..#####....##.###.......###..#.#..##...
##...#.#####.###.#####...#####..#.#..##.#.###..#.###.#..##.#.#..#.##....#....#.#..##.##.###.##..###.
.#....#.##.#..#.#.#.#.##...###..#...#..##.########.....####.#####..#.#..#.#.##....#..#.#..##.##.....
..#...#..###.#.#.#.##.#####.#.#...#...#..###...#...#.#.....##...#.###.#...###.....#..#.####.#.###.##
.#...##..#...#..#.#.#..######..##.....#######.####......##.#.##.#..##..#.##....#...##.###..###.#....
.#..#..###.####..#.##.###......####...#####...#..#.#.####..#..####.#.####..#..##.##.#.#...###...##.#
######.#....#.#......#..#..#....#.###...##..#.#.##.##.#.##.##.##.#..#.##.#.##.##...#.####.#.##...###
..####.#####.###.###.##..##..#..#..########..##.####..#..#..##.####.##.####.###....##..#..###...#..#
##.#....####.#..#...##...#..#..#.#..#.#.####...###.#.###.###...#..#.####.####.#......####.#####..#..
...#...#....##..#...#....###.....#.#...#.##.#######.....#..#.#.#...#..#.###.##.###....#...#.##.....#
##.#.#.#########...##.#########.#....#.#..#.##...##......#.##..###.####.#.#.#...#.##.##..##.##.##.##
.............#.#.#..##.#..#.#.####..#..###.###.##.#.#.###.#..#.#..#...###..###.##......#.###.###..##
..##.#.....#..###..##.#...###...###..##.#####...#.#.#.#...##.#.....###.####...####.##......#.#.#...#
##.#...#.......###...##..#.#..#..###...###..##......#.#.#...##..###...#..#.#..##.#...#..###.##..#.##
#...#.###.#..#...###..#.###.#####..##.###..#.##.##....####.#.##########..#####.###.###...##.#..##.#.
.#.#.#...#.#.#..#...##....#.#...###.#.#####.#.##.#....##..#.#..#..##..#..#........###..#..#.......##
####.##...#....#####...##.###.#...###..##....#....#.#.###..##.##.#....#...###..#####.##.#..###.##.##
..##..#.#.#.##.#.....#.#.....#.##..#.#.#..#.##.#..####.#...#.###.#...#####.##...###..#.#.#.#####.#..
#.###.##....##..#.##.#...#..###...#...#.......###...#.#..##...###.#.#.###..#.#####.#.###.##.#.####..
.#.###..##...#...####.##.##.##...#..#.#...#...#...#..##.###......#.#...#.#.#.#....#.#..#.##.#.####.#
.##########.#..#.##..#.###..#####.#..##.#......#.####..##.#.####.####.####....###.###.###...#.#..#..
#..##.###..#########......#..#.#.#..#.#.##...#.##.#...#.#.#.#...#.....##.#..#.######.###....#.#...#.
.##..#..##.#..#..####.#....##....###...#.####....############.#.......#.#.##.#...###.##.#...####.#..
#...#######..###..##......#....##....#.###.##..#.#.#.###.#.#.#.#.....##.#.#...####..#.#...#.#.#####.
..##.#.#...###....###..##.#######.#...##.#.#####.......#.#..##.#.#...##..##.#.#####..####....##..##.
#######.#.#.##.#.###..###.##..#.#.#.#..#...#...##..#...###..##.##..#.###.......##..##...#...#.#.##.#
#..#..#.###.#..#....##....#..####....#####.....##.##########.##.#...#..#.#.#.#.#.#.#.#.###..###..#..
.....##...##....#.....#.###..#.##.#..##...#..#.#####.##....####..##..##.##......#.#.#....###.#.#.##.
#..##....###...#.#.#...#.##......#.#####..#....#.#..#..#####.#.##..##.########.....#.#...#.########.
#.####...#....##..#.###....###.#......#..#..####.#.####.#...###.#..####...#....###...#.#..##.##..#..
....#.###....#...##......##.###.#####..##...######.##...#.#...#...#.###..#######.#####...#.#.####..#
.##.#.#..#..#.#.####..###.##....#...#.####..##.#...#..#.##..#.#.#...##.#...#..##.#..#####...#..##...
##.#..######.##..#.#.#...#.#.##....#...#.###...#####..#.#.....#...#.##..#...####.#..###.#.##.#.#..##
#.#..#.#...#.....#.##.###.#..#.###.#.#..###..##.#......#..#..##.....###.#...#.....##.#..###..##..#..
#.####.#.##.##..######.#.###...###.###...#.##......#..####...###..#..#.#.##.#....#####..##..##.#....
..##..#.#..#.####.#####.##.######.###..##.#.###.#...###.#.##..#.###.#########..##.#.#.#..#...###.###
##..#####.##.....#...###..####.##.#...#..#....###......##...#..#.#...##.#..###...#.#.#..##.##.#.#.##
#...#....#...###.##..##.#.##.......###.##.###..#.##.#.#.#...#..####.####.##.....##......##.##..###.#
..#...#...###.#.##.##.##.#.##...####..#..##..#..####.#.#..####...###.#.#...#..#..#.#....#.#.##.###.#
.###.#.#.##.......##...#.####.#.######.#..##....#.#.....#..#.#..####...#.#..##.....#.#.#.......##..#
########.#.####...###.#...##.#..##.#.#.#####.#...#...#.####...#####..#.###.....##...#..###.##...#.##
...#.....#..####......###.##.##.###.#.#.#..###..##..##########.###.######.###....#.#..######.###...#
##....#.#......#..##.###.#..#.....###.##.###.####..#.#...#..#####.#..##.#....##...#..##....#.###.#.#
.#.#...#..##..##.###.#...#.#.........###.#.#....#..#...#.###.####...#.#...#.....#...#####.###..#..#.
#...#.###......######.#...#.##.#.#.##.....####..#..##.##..##.#.###........###..####.######.#....#...
..####......##.#..#..#...#.###.######...####..##...#..###.##.#.######.#.##..#.##.##.##...####.#.....
..#.#.##..#.###..##.##.#.#.#.#.##....#.#.###..#.###.....#.#..########..##......##.#..###...#.##.##..
..#.....##..##.#..#.#..#..#.##..#.###..#..##.#..#.#..#..##.#.##..########.###.#.##.....#...#...#.###
...#..######..####......#..#............#.#..#.##..###.#...##....#..#..#.#.###.###.#..##...#.#......
...#.........#..##.##..#........#..#.##.....#...#.###.#.###.#.##.#####..#.##.#...#.###.###.#...#....
#..#####.##..####..###.#....#..#...#.####...#..#..##.#.###..##...###.#.#...##.#..####.#.#.#..##.#..#
..#..#...#.##.#.#.##.###...##..##.##.###...###.#..###...##.#..##.####....###.###..#.#..#.###.#.....#
.#.#.#.#....###.#..#..########.##.###..#.#.##..##..##.######...##.##..#.#.####.#.#####.#..#.##.####.
.##.#.##.##.#..#####..#.##..#.#.###..#..#..##...#.#.###.#.#.#...#..####.###.#........###.##..#...##.
.#.#####.#..##..##..##.#.#.#####.#.#.....#.#.#..#...#.#.#.####..#.#..#########...####..###.#...#.#..
.##..#..#.#.##.#.##..##.#.#..######..#..##..##...####.#.##..#.##.#..####.#.###...####..##...#.##..##
#..#.###..####.#####.#.#..#.##.##.##.##......#.#.###...#.........###...#.#.#.###.####.#..######..#.#
#.##########.#.##.##....#..#.######.####.#.####.##.####.##...###...#######.#..#.##..###.##..######..
....#.....#..###.......##.#...####...#.#..##.#..###..###...#...###.#..###.#.#.##.#.#.##.#....#...#..
..##...#.#.#.####.#..#.####...#...###.#..###..#.###.####....#.#....#...##...#.#.#....##.#.#.##....##